|------------------|
|                  |
|           3   8 5|
|     1   2        |
|       5   7      |
|     4       1    |
|   9              |
| 5             7 3|
|     2   1        |
|         4       9|
|------------------|
|------------------|
|                  |
|           7   2 5|
|     9   8        |
|       5   3      |
|     6       9    |
|   1              |
| 5             3 7|
|     8   9        |
|         6       1|
|------------------|
|------------------|
| 9       4        |
|         1   2    |
| 3 7             5|
|               9  |
|     1       4    |
|       7   5      |
|         2   1    |
| 5 8   3          |
|                  |
|------------------|
|------------------|
| 1       6        |
|         9   8    |
| 7 3             5|
|               1  |
|     9       6    |
|       3   5      |
|         8   9    |
| 5 2   7          |
|                  |
|------------------|
